Id,Label,timeset,elo,bucket,community,indegree,outdegree,Degree
kalitka_man,,,2025.150538,2000,1,47,46,93
ZeruHmyz,,,2213.04717,2200,1,168,150,318
PRESA,,,2511.423077,2480,0,12,14,26
Blitzstream-twitch,,,2381.953846,2360,0,30,35,65
Pikuro,,,2053.627451,2040,1,80,71,151
IvTK,,,2054.492308,2040,1,33,32,65
Matetricks,,,2515.083333,2480,0,6,6,12
orsonico,,,2028.818182,2000,1,5,6,11
pythondave,,,2151.175,2120,0,11,7,18
amin2101,,,2015,2000,1,1,1,2
DragonRU,,,2210.5,2200,1,3,3,6
tens,,,2012.142857,2000,1,10,11,21
solenko,,,2018.763158,2000,3,2,0,2
jankud,,,2069.794872,2040,1,20,19,39
Yegresmd,,,2113.473684,2080,1,34,42,76
Mohsenabutalebi,,,2162.388889,2160,1,8,8,16
monstrella,,,2042.5375,2040,1,36,44,80
amayak,,,2055.34375,2040,1,33,31,64
iman60,,,2021.395833,2000,1,19,29,48
larpayam,,,2057.686275,2040,1,26,25,51
looka,,,2029.83871,2000,1,17,14,31
brahmsguitar,,,2014,2000,1,1,1,2
ZibbitVideos,,,2191.166667,2160,0,2,4,6
lokomotiv_bz,,,2070.5,2040,0,3,1,4
Chalberts,,,2135.541176,2120,1,42,43,85
tibi,,,2085.3,2080,1,2,38,40
Daltonic,,,2031.833333,2000,1,2,4,6
avv,,,2087.384615,2080,1,38,40,78
phil9234,,,2025.714286,2000,1,5,2,7
mecker,,,2187.485263,2160,1,402,548,950
elrond,,,2161.190476,2160,0,34,29,63
zergy,,,2302.306667,2280,0,37,38,75
Jusuf-Np,,,2078.657143,2040,1,47,58,105
antoinette,,,2084.555556,2080,0,5,4,9
moj1990,,,2052.468254,2040,1,32,29,61
a2a4h7h5,,,2013,2000,1,1,0,1
crazyslon,,,2043.185185,2040,1,40,41,81
arpouille,,,2112.528846,2080,1,45,59,104
MR-Siamak,,,2112.421053,2080,0,10,9,19
TTZO,,,2076.628571,2040,1,18,17,35
Berezkin,,,2142.92931,2120,1,148,140,288
Siline,,,2017.444444,2000,1,4,5,9
caiosparov,,,2020.722222,2000,1,7,11,18
jiktak,,,2094.010714,2080,1,18,22,40
ohdy,,,2068.266667,2040,9,7,8,15
zembelek,,,2043.666667,2040,1,61,47,108
ATorrente,,,2069.519481,2040,1,39,38,77
xaxaxaxa,,,2122.166667,2120,1,2,4,6
milanbelobrk,,,2052.807692,2040,1,14,12,26
krassparov,,,2067.321839,2040,1,41,46,87
pilocl,,,2046.932203,2040,1,226,10,236
babken,,,2090.446154,2080,1,59,71,130
ryksuguskyr,,,2044,2040,1,0,2,2
artin-iran,,,2044.714286,2040,1,5,2,7
andreasw,,,2088.25,2080,1,3,1,4
cesar1994,,,2044.388889,2040,1,10,8,18
Bozantium666,,,2146.2,2120,2,4,6,10
frost111,,,2035,2000,1,0,1,1
rj1997,,,2040.068966,2040,1,17,12,29
RBT02X,,,2056.5,2040,2,1,1,2
jotjesus,,,2128.118644,2120,1,66,52,118
Valtor,,,2023.666667,2000,0,1,2,3
Svonti,,,2034.571429,2000,1,2,5,7
RobbyFischer,,,2085.688889,2080,3,1,2,3
Drak,,,2171,2160,1,3,1,4
mxs,,,2063.666667,2040,2,0,1,1
chesslion,,,2023.5,2000,1,1,1,2
Nevski,,,2038.218487,2000,3,2,3,5
samir0009,,,2096.846154,2080,3,8,5,13
Laudatio,,,2031.608696,2000,1,9,14,23
shelajev,,,2057.370861,2040,1,73,78,151
TheIniciative,,,2083.333333,2080,2,3,3,6
pridoni,,,2037.027473,2000,2,12,12,24
Shaeferov,,,2042.1,2040,1,16,14,30
sosisamm,,,2100.444444,2080,0,13,14,27
Germain,,,2027,2000,1,75,79,154
GodsLeftHand,,,2060,2040,1,1,0,1
CaicoAmaral,,,2041.5,2040,1,17,17,34
kabaplanca,,,2023.733333,2000,1,15,15,30
jorquerino,,,2277.3,2240,1,13,17,30
Horobetz,,,2316.130435,2280,0,24,22,46
BND,,,2049.604167,2040,1,20,28,48
gambitron9000,,,2009,2000,2,1,0,1
Protoreus,,,2037.539683,2000,1,30,33,63
freakyavocado,,,2009,2000,0,2,0,2
naiche,,,2100.88,2080,1,25,25,50
cavanof,,,2317.422222,2280,0,22,23,45
AnatoliyPechenkin,,,2025.170732,2000,1,20,21,41
Albator,,,2172.0625,2160,0,28,36,64
tocaifriulano,,,2120,2120,1,11,6,17
potus0,,,2115.5,2080,13,7,7,14
ruter,,,2085.8,2080,1,21,19,40
dan31,,,2072.4,2040,1,3,2,5
Chess_mosaics,,,2035.25,2000,1,20,20,40
arc_chess,,,2156,2120,1,13,9,22
Adegeminas,,,2081.666667,2080,1,2,4,6
KG_Chess,,,2075,2040,1,1,3,4
twitch_martiss45,,,2036.75,2000,9,1,1,2
abarmard765,,,2082.404255,2080,1,28,64,92
likor64,,,2054.75,2040,1,1,3,4
gimpel,,,2217.363636,2200,1,5,6,11
Shermukshnelis,,,2146,2120,2,0,1,1
intobolivian,,,2012,2000,2,2,1,3
sidneycrode,,,2066.5,2040,1,2,6,8
BearJr,,,2082.756757,2080,1,15,22,37
catzilla,,,2017.111111,2000,1,3,6,9
ManFromMars,,,2011.5,2000,1,2,2,4
peor2,,,2025,2000,1,0,1,1
gulixuli,,,2058.333333,2040,1,3,3,6
romarfa,,,2233.2,2200,1,2,3,5
donairo,,,2022.8,2000,1,8,7,15
Vihvillain,,,2075.576577,2040,0,19,16,35
manono,,,2035.8,2000,1,3,2,5
jorquerov,,,2040.95122,2040,1,21,20,41
ramon444,,,2097.465116,2080,1,18,25,43
Capivarabq,,,2005.666667,2000,1,0,3,3
InTheEnd,,,2372.181818,2360,1,5,6,11
eviltwin,,,2011.111111,2000,1,4,5,9
antavirus,,,2030,2000,1,0,4,4
JimmyMow,,,2008,2000,0,0,1,1
dodi65,,,2035.3,2000,1,13,17,30
Nrock,,,2108.3,2080,2,5,5,10
oleg_h,,,2011,2000,1,2,3,5
aronian1,,,2072.333333,2040,1,0,3,3
mazetr,,,2045,2040,1,9,5,14
Castlan,,,2081.166667,2080,1,6,6,12
Suerte,,,2051.142857,2040,13,4,3,7
runawayscared,,,2082.238095,2080,1,23,17,40
GoodTimes,,,2160.772727,2160,1,12,10,22
otk,,,2149.5,2120,0,0,2,2
sansechess,,,2036,2000,1,2,2,4
sisili,,,2055,2040,2,15,10,25
Camembert,,,2029,2000,1,0,1,1
upandcomer,,,2078.833333,2040,1,5,7,12
boatsnhoes,,,2037,2000,0,0,1,1
arina1999,,,2215.36044,2200,0,30,33,63
qweqweqweqwe1,,,2104,2080,1,3,4,7
frantoro,,,2015.2,2000,1,2,3,5
Polmipoque,,,2064.8,2040,1,4,6,10
JackBauer,,,2041,2040,3,0,2,2
Stupidity_Tries,,,2276.0625,2240,0,9,7,16
istil,,,2095.743056,2080,4,7,3,10
Pterodactyl,,,2193.576271,2160,1,58,60,118
alemzo,,,2007.5,2000,1,1,1,2
Monyassa,,,2003,2000,1,1,0,1
zoranz,,,2018.130435,2000,1,11,12,23
Koji,,,2010.25,2000,1,3,1,4
bluediamond7,,,2010.25,2000,1,1,1,2
macho2014,,,2011,2000,1,1,0,1
ecbg,,,2127.014286,2120,1,36,34,70
fidelgo,,,2035.666667,2000,1,1,0,1
Miniplus,,,2068,2040,0,0,1,1
itsmagic,,,2091.866667,2080,2,15,15,30
mixst,,,2142.2,2120,1,1,4,5
RSPIRES2,,,2007.5,2000,1,3,1,4
nikolaRBM,,,2116.637255,2080,1,51,51,102
csm,,,2041.416667,2040,1,6,6,12
zimar,,,2058,2040,2,0,1,1
pacal56,,,2234.690909,2200,0,348,257,605
kromzom,,,2091.596154,2080,1,25,27,52
androsh,,,2012,2000,1,1,0,1
TrickOrTreat,,,2431.692308,2400,0,13,13,26
fogof,,,2139.666667,2120,2,2,1,3
Desteyn-2014,,,2008,2000,1,1,0,1
Safifa,,,2136,2120,2,2,1,3
spojar,,,2110.273128,2080,1,120,107,227
yasrdhbol,,,2261,2240,0,0,1,1
playcheckers,,,2034.928571,2000,1,8,6,14
jorp,,,2043.428571,2040,1,5,2,7
AntaresS81,,,2144.25,2120,1,24,16,40
GMICE,,,2037,2000,1,2,1,3
DRAGONUA,,,2111,2080,0,0,1,1
cantona1362,,,2113.25,2080,1,2,2,4
Eliobonor,,,2099,2080,1,0,1,1
saber-v,,,2015.272727,2000,2,5,6,11
icediamond7,,,2062,2040,0,0,1,1
t-feng,,,2072.111111,2040,1,8,8,16
kesarev,,,2313.690476,2280,0,21,21,42
pmsryu,,,2030.979167,2000,1,22,26,48
Gorn,,,2177.32,2160,0,12,13,25
Buzzz2,,,2002,2000,1,1,0,1
amourmonstre,,,2416.1875,2400,0,14,18,32
Thecheesykid,,,2212,2200,0,2,2,4
Dajaneira,,,2023.076923,2000,1,6,7,13
gligorije,,,2008.875,2000,1,4,4,8
gojkon,,,2032,2000,1,3,5,8
KNST_495_888,,,2016,2000,0,1,0,1
MensaNTXS,,,2043.25,2040,1,1,3,4
ImprovingSkill,,,2237.927273,2200,0,1,2,3
macr0,,,2015.333333,2000,1,0,3,3
faku312,,,2039.5,2000,17,0,2,2
motet,,,2046,2040,17,1,0,1
amirkhafan,,,2409.441176,2400,0,13,21,34
andrei70ster,,,2019.333333,2000,1,2,1,3
Castrito,,,2062,2040,0,1,2,3
Permanganato,,,2011,2000,0,1,0,1
gladpie,,,2026.875,2000,2,3,5,8
denizn,,,2232,2200,1,15,17,32
desmo,,,2006.333333,2000,1,1,2,3
Gravey4rd,,,2337.8,2320,1,33,25,58
raskolnikov56,,,2239.75,2200,0,12,12,24
blueguy7,,,2124,2120,2,0,1,1
Anomander,,,2241.529412,2240,1,10,7,17
Kiyotaka,,,2161.2,2160,1,2,3,5
JeanH,,,2192.348837,2160,0,19,24,43
Petrovich63,,,2106.338462,2080,1,33,32,65
mahavj,,,2039.625,2000,2,2,6,8
labo531,,,2122.5,2120,0,1,3,4
BigRip,,,2164.769231,2160,1,16,23,39
Romoda,,,2169.09434,2160,1,23,30,53
Portos2010,,,2156.6,2120,3,5,9,14
DeathInTheToilet,,,2058.026316,2040,1,25,13,38
konakjan,,,2019.25,2000,0,2,2,4
Skinmaster,,,2068.388889,2040,1,8,10,18
rymrym2929,,,2012.875,2000,1,3,5,8
jaier,,,2132.894737,2120,1,6,11,17
breizhladen,,,2080.583333,2080,1,5,7,12
salagaa,,,2026,2000,2,0,1,1
_coco_,,,2011.2,2000,2,1,4,5
Reppko,,,2080.230769,2080,0,7,6,13
mahyar-90,,,2074.232143,2040,1,30,26,56
guardman,,,2072.423077,2040,1,10,16,26
Blake,,,2056.25,2040,1,4,8,12
Porfirios,,,2035.015625,2000,1,31,33,64
D_Stahlberg,,,2098.511765,2080,3,4,4,8
amigochez,,,2001,2000,2,0,1,1
Barista,,,2034.5,2000,1,1,1,2
jlindner,,,2187.793103,2160,0,23,35,58
wichy,,,2040.703704,2040,1,11,16,27
kaZuHA,,,2039,2000,2,1,0,1
Alexinio99,,,2146.5,2120,0,0,2,2
olborg,,,2097.062857,2080,1,13,20,33
liargo,,,2014.666667,2000,1,2,1,3
dj770,,,2016,2000,1,0,1,1
ayka_99,,,2052.76,2040,1,14,11,25
nikolaypetkov_bnpp,,,2016,2000,1,1,0,1
MontessoriChess,,,2061,2040,0,1,0,1
RezachessMaster78,,,2170.25,2160,1,2,6,8
frenck1,,,2037.68254,2000,1,6,10,16
JoaBN,,,2308.333333,2280,0,3,2,5
zuriko,,,2042.263158,2040,1,7,12,19
paul58,,,2006.4,2000,1,3,2,5
shredded,,,2286.4,2280,0,5,5,10
Svesh,,,2034.25,2000,0,5,11,16
Lediamov,,,2024.344828,2000,1,16,11,27
DuraznoSangrante,,,2012.222222,2000,1,7,2,9
taulajoe,,,2033,2000,1,1,0,1
Farshad54,,,2058.020202,2040,1,52,47,99
iuser76,,,2229.588235,2200,0,7,10,17
Bordok,,,2078.105263,2040,1,88,83,171
ChikChak,,,2014,2000,1,1,0,1
Akademia0,,,2047.6,2040,1,3,2,5
Laterp,,,2045.5,2040,1,1,1,2
iuytrewq147,,,2545,2520,0,0,1,1
Patrizsche,,,2145.175,2120,1,7,7,14
JakobBo,,,2115.222222,2080,1,4,5,9
claymore,,,2093.333333,2080,0,4,2,6
worms123,,,2017,2000,2,0,2,2
moutcho,,,2097.555556,2080,1,5,4,9
Ed1,,,2096,2080,1,0,1,1
fymax,,,2163.591549,2160,0,35,36,71
goltrpoat,,,2012,2000,1,1,1,2
tranca,,,2074,2040,1,0,1,1
FuturoMestre,,,2053.75,2040,1,4,4,8
thegoodknight,,,2009,2000,1,0,1,1
yuio,,,2010,2000,1,3,3,6
Dreampower,,,2095.2,2080,1,3,2,5
hosein1970,,,2026.857143,2000,2,5,2,7
naser-----,,,2119,2080,1,1,0,1
raMtiN_MagNuS,,,2050,2040,3,1,1,2
Chovier,,,2133.8,2120,1,1,2,3
vktrch,,,2163.1875,2160,2,9,7,16
covua3001,,,2019.333333,2000,1,1,2,3
iNUiT_nUNAAt,,,2180.666667,2160,2,2,1,3
jthc,,,2049,2040,0,1,0,1
_-horror-_,,,2086.833333,2080,1,4,2,6
vit2014,,,2073.545455,2040,2,10,12,22
TASSADAR,,,2078.038462,2040,1,20,17,37
Ratatinator,,,2038.333333,2000,0,8,4,12
homoeporediensis,,,2002.666667,2000,2,2,1,3
bizamil,,,2056,2040,1,7,6,13
Maricki,,,2019.454545,2000,2,5,6,11
abucavid,,,2059.888889,2040,3,4,3,7
infinite-automata,,,2099.923077,2080,0,5,8,13
eqellar,,,2018.25,2000,0,2,2,4
Kobylka,,,2065.444444,2040,1,14,13,27
magic-milo,,,2046.748918,2040,2,14,17,31
chessmusic,,,2102.834711,2080,1,60,61,121
argo,,,2005.5,2000,0,2,0,2
fotc,,,2033.75,2000,1,2,2,4
crazymetalxxx,,,2047,2040,3,1,1,2
CormoranKR,,,2021.914286,2000,3,3,2,5
bahar1389,,,2023,2000,1,0,2,2
arminJM,,,2077,2040,1,1,1,2
Nerwal,,,2087.625,2080,4,10,6,16
gile2510,,,2006,2000,1,1,0,1
gus_fring,,,2197.25,2160,0,2,2,4
upep,,,2068.641026,2040,1,23,16,39
ryujin,,,2052.066667,2040,1,3,0,3
Twinpeaks,,,2027,2000,0,2,0,2
xX420_N0Sc0p3zXx,,,2049,2040,3,1,0,1
clipperton,,,2057.5,2040,0,3,1,4
MLUN,,,2068.889764,2040,1,69,58,127
gpv,,,2018,2000,2,4,1,5
expert700,,,2044.333333,2040,1,2,1,3
RudolfSpielmann,,,2155,2120,1,1,0,1
Hallon,,,2014.666667,2000,1,2,1,3
ver_vas,,,2071.285714,2040,1,4,3,7
kostya19841,,,2065.423077,2040,2,12,14,26
Ced97418,,,2026,2000,2,0,1,1
milancuruvija,,,2039.356643,2000,1,52,91,143
VasiliyProkopiev,,,2007,2000,1,1,0,1
predejan,,,2017.666667,2000,1,2,4,6
MKna150,,,2030.093333,2000,3,4,4,8
ozzychess,,,2004.5,2000,1,0,2,2
Phaethon,,,2118,2080,0,8,6,14
hackauron,,,2062,2040,0,0,1,1
inzeitnot,,,2067.514286,2040,1,18,17,35
kurton,,,2352.774468,2320,1,108,127,235
osipov,,,2006,2000,0,0,1,1
gracioso13,,,2182,2160,1,0,1,1
tuskerking,,,2092,2080,0,1,3,4
watov,,,2300,2280,0,1,0,1
escalibut,,,2041,2040,2,7,2,9
Jcat84,,,2118.857143,2080,1,9,19,28
SRF12jul12,,,2149.5,2120,1,1,1,2
blastol,,,2124.846154,2120,1,25,27,52
serge_vw1,,,2052.666667,2040,1,2,1,3
Frankel,,,2008,2000,0,0,1,1
GMShaokhan,,,2108.5,2080,1,2,2,4
Vulpini,,,2060,2040,2,1,2,3
areza,,,2034,2000,2,1,1,2
x014y,,,2007,2000,1,0,1,1
glablabla,,,2078,2040,1,1,0,1
MorozevichA,,,2144,2120,1,3,2,5
fhermann,,,2092.75,2080,2,5,3,8
rubiking,,,2042,2040,1,0,1,1
deda1946,,,2008.5,2000,1,1,1,2
joaoluizmonnerat,,,2007.666667,2000,1,1,2,3
igorxxx,,,2007.5,2000,1,1,1,2
Daddylonglegs,,,2027,2000,1,1,1,2
chesswolf,,,2032,2000,1,1,0,1
DuetKiller,,,2092,2080,1,1,1,2
Seredas,,,2331,2320,1,1,5,6
jeffforever,,,2417,2400,0,1,1,2
JokingHero,,,2042.333333,2040,1,0,1,1
TrialB,,,2056.3,2040,1,12,8,20
Artusik12357,,,2042,2040,1,1,0,1
nuam,,,2024,2000,1,7,10,17
SVIST15,,,2060,2040,1,1,4,5
ayathustra,,,2062.55,2040,1,12,8,20
langyen,,,2071,2040,1,1,0,1
anty,,,2023.666667,2000,3,1,2,3
nafnaf54,,,2192,2160,1,1,0,1
jstraaten,,,2046.153846,2040,1,10,16,26
HydroLux,,,2336,2320,21,0,2,2
baba0,,,2473,2440,21,1,0,1
outlier,,,2062.857143,2040,2,30,26,56
jjvolf79,,,2140,2120,4,1,1,2
fidel_go,,,2062.5,2040,1,9,7,16
kazablanka,,,2026.2,2000,1,3,7,10
take-it-ez,,,2416,2400,1,0,1,1
RPG77,,,2157,2120,1,2,1,3
JaffaCakes,,,2024,2000,1,1,1,2
55555,,,2020,2000,1,1,0,1
banebojnik,,,2029.333333,2000,25,1,2,3
kknight,,,2059.340909,2040,1,22,22,44
KarelusMaximus,,,2042,2040,22,0,1,1
PawnGambit,,,2040,2040,22,1,0,1
MingChang,,,2276.202041,2240,0,24,23,47
seigneur,,,2077.5,2040,1,1,5,6
alejandroo19,,,2186.666667,2160,1,1,2,3
juanze21,,,2020.806452,2000,1,18,13,31
mesi2014,,,2051.285714,2040,2,4,3,7
daunuoc,,,2045,2040,1,1,0,1
attitudal,,,2071.666667,2040,1,2,1,3
suadba,,,2043.5,2040,0,3,1,4
malachi76,,,2090.48,2080,1,12,13,25
xequito,,,2013.5,2000,2,1,1,2
joe59,,,2103,2080,1,1,0,1
alekhin1937,,,2039,2000,1,1,0,1
fdd5544w,,,2055,2040,1,1,0,1
mixx,,,2044.833333,2040,2,4,2,6
chessnightmare,,,2245.179487,2240,0,19,20,39
zorro2014,,,2094.428571,2080,1,7,7,14
Vadim3000,,,2003,2000,1,1,0,1
topazxan,,,2019,2000,2,1,1,2
zdenek,,,2099,2080,2,1,0,1
_-moloch-_,,,2029.166667,2000,1,4,2,6
Shouldbeworking,,,2052.333333,2040,1,2,1,3
narkohat,,,2036.5,2000,2,1,1,2
darewing,,,2007.75,2000,2,1,3,4
lasker2,,,2101.235294,2080,1,8,9,17
Giftzwerg,,,2072,2040,1,1,0,1
Chiribim,,,2103.666667,2080,1,1,2,3
Delgeriatrico,,,2025.923077,2000,1,4,7,11
azaharia,,,2008,2000,1,2,1,3
BOZ969,,,2197,2160,1,1,0,1
TT-68,,,2084.357143,2080,1,9,5,14
yhtushko,,,2008,2000,1,2,1,3
payman7,,,2022.107143,2000,1,16,12,28
pingogigante,,,2107.636364,2080,0,4,7,11
duzi1964,,,2067.458333,2040,1,3,3,6
gogf88,,,2001,2000,1,1,0,1
Maria_K,,,2101.95082,2080,1,32,29,61
mich_5,,,2088,2080,1,1,0,1
pulkownik0,,,2087.333333,2080,1,4,5,9
ttee,,,2416,2400,0,1,0,1
lifeislive,,,2125.5,2120,2,2,0,2
babi123,,,2528,2520,1,0,1,1
LRJ,,,2051,2040,1,0,1,1
nilocairo,,,2006,2000,1,0,1,1
Neologic,,,2231.666667,2200,1,2,1,3
leo0021,,,2003,2000,1,1,1,2
vadikass,,,2014.5,2000,1,2,2,4
GMstrange,,,2078,2040,2,1,1,2
accelix,,,2008.333333,2000,1,2,1,3
ramires84,,,2174,2160,1,1,0,1
sachinder,,,2016,2000,2,4,3,7
vvai,,,2067.25,2040,2,2,2,4
avanti,,,2012.375,2000,1,3,5,8
Ns7edR0EMCZONRp1g7FN,,,2089,2080,1,0,1,1
Orochimaru,,,2319.8,2280,1,8,7,15
hentes81,,,2038.5,2000,2,0,4,4
Toadofsky,,,2006.5,2000,2,2,0,2
qazplmwsxokn,,,2158,2120,4,1,1,2
Quanganh1025,,,2054.625,2040,1,5,3,8
faulschlamm1,,,2104.596774,2080,1,35,27,62
arkadi1958,,,2005,2000,1,0,1,1
Kamillentee,,,2080.387097,2080,1,15,16,31
kapa2,,,2101,2080,4,5,2,7
litavrist,,,2061.08,2040,4,3,5,8
gambiterr,,,2122.5,2120,0,1,1,2
MurphyLasker,,,2038,2000,1,1,0,1
GruenfeldAdict,,,2023.4,2000,1,3,2,5
kmd007,,,2116.5,2080,1,2,4,6
bikhial,,,2170,2160,0,0,1,1
StrongAttacker,,,2038,2000,1,1,0,1
Bg7,,,2079,2040,1,1,1,2
antonov666,,,2373,2360,0,1,0,1
ant1999chess,,,2158,2120,1,0,1,1
Aplitic,,,2236.714286,2200,1,2,5,7
Chessrk,,,2025,2000,1,1,0,1
MONOZEVICH,,,2097,2080,0,1,0,1
AceofSpies,,,2148,2120,1,2,1,3
lindogatito,,,2041.8,2040,1,3,2,5
Salgadim,,,2183.416667,2160,1,5,7,12
EricKaneda,,,2032.8,2000,1,3,2,5
vevesem,,,2165.810345,2160,1,26,32,58
angelus666,,,2212,2200,24,0,1,1
Breslin,,,2129,2120,24,1,0,1
Draker,,,2023,2000,1,0,1,1
alkemisti,,,2135,2120,16,4,3,7
river13,,,2031.5,2000,2,1,1,2
Sergeguillemart,,,2017,2000,0,2,1,3
ari_atoy,,,2057.5,2040,1,0,2,2
master-chess,,,2083,2080,25,2,3,5
Assios,,,2119.166667,2080,0,5,5,10
Spinaltap,,,2407.5,2400,0,2,2,4
mtluser,,,2069.25,2040,0,2,2,4
mfaraji,,,2075.666667,2040,1,1,2,3
DarkHole,,,2167,2160,1,1,0,1
rigby,,,2249.2,2240,1,3,2,5
ZugAddict_Twitch,,,2006,2000,1,1,0,1
andrewrun,,,2178.5,2160,0,2,2,4
anand1,,,2025.416667,2000,1,7,5,12
ql50,,,2066,2040,1,0,1,1
zhoskirocker,,,2032.444444,2000,1,4,5,9
MxTriX_,,,2050.833333,2040,4,0,1,1
cinics,,,2005.5,2000,4,0,2,2
fi05,,,2089.666667,2080,1,2,4,6
ChessBeam,,,2092.5,2080,1,0,2,2
maulwurf,,,2032,2000,0,0,2,2
croarh51,,,2263.175,2240,1,22,18,40
Sergio_Aguero,,,2032.52381,2000,1,23,19,42
matutin,,,2082,2080,1,4,1,5
Blitzki,,,2003,2000,0,1,0,1
einsam,,,2001,2000,1,0,1,1
resmir,,,2043.4,2040,1,3,2,5
demaupassant,,,2242.333333,2240,0,1,2,3
vvvbbbbnnnggg,,,2029.666667,2000,3,0,1,1
chesserstein,,,2248,2240,0,1,1,2
vas1945,,,2063.5,2040,2,3,5,8
CanadianChess,,,2088.666667,2080,1,0,3,3
Hossein1992,,,2004.5,2000,1,0,2,2
svetozar,,,2068,2040,2,0,1,1
shaf,,,2311.125,2280,0,3,5,8
tatalimov,,,2017.772727,2000,1,14,8,22
Huevon,,,2013,2000,0,0,1,1
alexandr7522,,,2104.5,2080,1,3,3,6
alexthegreat,,,2058.2,2040,1,5,5,10
flogislife2,,,2005,2000,1,1,1,2
Serzh1956,,,2071.157143,2040,1,5,7,12
ranzo,,,2004,2000,1,1,0,1
aoao,,,2049,2040,1,1,0,1
Xaxatun,,,2068,2040,1,1,1,2
oxymoron21st,,,2107.769231,2080,1,6,7,13
Yukhno_Alexander,,,2250.125,2240,1,6,2,8
Justlikemusic,,,2042,2040,16,2,1,3
-_si_-,,,2045.5,2040,1,1,1,2
azaaadi2002,,,2206.5,2200,1,1,1,2
rashtao,,,2004,2000,1,0,1,1
rigosj,,,2046.666667,2040,2,1,2,3
Luters,,,2113.875,2080,1,3,3,6
ribarisah,,,2036.771429,2000,0,1,0,1
yasir752,,,2074.202614,2040,1,26,23,49
BlauerKlaus,,,2008,2000,1,0,1,1
gari-k,,,2118.555556,2080,2,22,32,54
SuperMi,,,2097.209302,2080,1,20,21,41
shaxMSTAtist,,,2025.666667,2000,1,4,2,6
Letins888,,,2042,2040,1,0,1,1
alia234,,,2039.5,2000,2,1,1,2
josefranciscotrator,,,2005,2000,1,0,1,1
nuwonga,,,2193,2160,1,9,11,20
vepashka,,,2015,2000,1,6,2,8
knopp,,,2140,2120,1,2,2,4
LoroVerde,,,2099.382979,2080,1,25,22,47
OCoringa,,,2230.8,2200,0,2,3,5
darhaa,,,2022.6,2000,1,5,5,10
topce,,,2250.235294,2240,0,17,17,34
Tikal,,,2072.5,2040,1,2,2,4
Morphy91,,,2023,2000,1,1,2,3
shatrangbaz,,,2045.5,2040,1,1,1,2
Riddik345,,,2237.75,2200,1,5,3,8
Piquro,,,2031.414634,2000,1,22,19,41
amir79,,,2011,2000,1,0,1,1
ENERGIE73,,,2269.733333,2240,0,15,15,30
dreamwalker3,,,2021.833333,2000,0,2,2,4
ellince,,,2015,2000,1,2,0,2
Vicious,,,2024,2000,1,1,1,2
johny_,,,2062,2040,3,3,0,3
PowerfulChessPlayer,,,2113,2080,0,0,1,1
Philidor1792,,,2042.5,2040,1,7,7,14
Pierrodactyle,,,2002,2000,1,0,1,1
TheOldOne,,,2015.75,2000,1,3,1,4
luc5,,,2116.5,2080,1,1,1,2
KotovSyndrome,,,2032,2000,1,1,0,1
Lunaticz,,,2018.5,2000,1,1,3,4
pulkownik1,,,2167.3,2160,1,36,34,70
lttoledo,,,2264,2240,1,0,1,1
erteg47,,,2007,2000,0,1,0,1
whatever,,,2014.333333,2000,1,1,2,3
Teddie,,,2006.333333,2000,1,0,3,3
dorsa1392,,,2014.333333,2000,2,1,2,3
DariusIV,,,2127.333333,2120,0,1,2,3
Bouchard,,,2070,2040,0,1,0,1
lukdimarco,,,2030,2000,1,1,0,1
saeedherox,,,2168.387097,2160,1,18,13,31
okazaki,,,2079,2040,1,1,0,1
InsanePwn,,,2068.777778,2040,1,10,8,18
predejanex,,,2017,2000,1,0,2,2
arna,,,2213,2200,0,2,0,2
Confutatis,,,2145.333333,2120,2,2,1,3
kotbegemot,,,2010,2000,1,1,0,1
olacy,,,2010,2000,2,1,2,3
rafaking,,,2040,2040,1,1,3,4
YouralterEgo,,,2008,2000,1,0,1,1
shammies,,,2002,2000,0,1,0,1
eternauta,,,2008,2000,0,1,0,1
Shachspielkunst,,,2072,2040,1,1,2,3
night_rid3r,,,2076.4,2040,1,3,2,5
Lajosportis,,,2006.5,2000,0,1,1,2
mokachino,,,2110.5,2080,1,0,2,2
godes,,,2214,2200,1,1,1,2
king146,,,2326.5,2320,1,2,0,2
wheeee,,,2064.5,2040,0,0,2,2
klaja,,,2073.214286,2040,1,21,21,42
Wachen,,,2089.75,2080,1,2,2,4
ujura,,,2078,2040,0,1,0,1
SSAARR,,,2017,2000,1,1,0,1
astra,,,2019.75,2000,1,1,3,4
Tjoffen,,,2145.444444,2120,1,4,5,9
alienb,,,2025,2000,1,1,0,1
thoegersen,,,2046.5,2040,1,1,1,2
paloverdekid,,,2161,2160,1,1,0,1
honzarusnak,,,2058.75,2040,1,3,1,4
diogo007,,,2252.714286,2240,2,2,5,7
Pulsy,,,2101,2080,1,1,0,1
mstfa0,,,2265.8,2240,1,2,3,5
_-Mr_Vitaliy-_,,,2006.5,2000,1,1,1,2
ketoprak,,,2105.25,2080,1,2,2,4
nadbog,,,2205.666667,2200,1,3,0,3
konyol,,,2147.8,2120,1,4,6,10
OPTYMUS,,,2094,2080,1,0,1,1
vay_ayi,,,2186.727273,2160,1,5,6,11
danielcuva,,,2010.5,2000,2,1,5,6
gamlet,,,2024.5,2000,2,2,4,6
Sonata2,,,2032.333333,2000,1,3,0,3
CrazyMadMax3,,,2003,2000,0,0,1,1
drseuss,,,2061.142857,2040,2,3,4,7
jarda,,,2095.590909,2080,1,14,8,22
watchout700,,,2075,2040,1,1,0,1
Magnushoracio,,,2122.333333,2120,2,2,1,3
vicam,,,2022,2000,0,1,0,1
Red_Allert,,,2005,2000,2,1,0,1
Dake,,,2107.5,2080,2,0,2,2
Matador_Angelo,,,2010.666667,2000,2,2,1,3
turbocut,,,2034,2000,31,0,1,1
zerosquad,,,2077,2040,31,2,0,2
suparno,,,2189.888889,2160,1,4,5,9
tembelek,,,2199,2160,1,3,1,4
ketombe,,,2188.75,2160,1,3,1,4
javadsharoi,,,2050.6,2040,4,4,1,5
shutyomov,,,2020,2000,1,0,1,1
VELHOTE,,,2007.666667,2000,2,2,1,3
DontBeMad,,,2092.333333,2080,0,1,2,3
ldlan,,,2248.5,2240,1,2,0,2
Cliquot,,,2017.666667,2000,1,2,1,3
my_revenge,,,2004,2000,1,1,0,1
gmv,,,2105.722222,2080,1,10,8,18
papito2014,,,2061,2040,1,0,1,1
moi373737,,,2065.333333,2040,3,0,1,1
bulus,,,2135.5,2120,1,1,1,2
mustaplak,,,2097.8,2080,1,3,2,5
andreichess,,,2064,2040,2,1,0,1
